 * The Death of Ivan Ilyich - Leo Tolstoy
 * Metamorphosis and Other Stories - Franz Kafka
 * The Courage To Be Disliked - Ichiro Kishimi, Fumitake Koga
 * The Trial - Franz Kafka
 * The First Man - Albert Camus
 * Prophet Song - Paul Lynch
 * Michael Collins: A Biography - Tim Pat Coogan
 * Waiting for Godot - Samuel Beckett
 * The Last Revolution: The Story of the Official IRA and the Workers' Party - Brian Hanley, Scott Millar
 * De Valera: Long Fellow, Long Shadow - Tim Pat Coogan
 * The Idiot - Fyodor Dostoyevsky
 * Demons - Fyodor Dostoyevsky
 * The Gulag Archipelago: The Authorized Abridgement - Aleksandr Solzhenitsyn
 * On Human Nature, Studies in Pessimism, etc. - Arthur Schopenhauer
 * Invisible Cities - Italo Calvino
 * The Grapes of Wrath - John Steinbeck
 * On the Road - Jack Kerouac
 * Desolation Angels - Jack Kerouac
 * Slaughterhouse-Five - Kurt Vonnegut
 * Catch-22 - Joseph Heller
 * Blood Meridian - Cormac McCarthy
 * White Noise - Don DeLillo
 * The Iliad of Homer - Homer
 * The Metamorphoses - Ovid
 * Plato: Five Dialogues - Plato
 * The Art of Rhetoric - Aristotle
 * Aristotle's Nicomachean Ethics - Aristotle
 * Discourses, Fragments, Handbook - Epictetus
 * Don Quixote - Miguel De Cervantes Saavedra
 * Ulysses - James Joyce
 * The Poetics of Space - Gaston Bachelard
 * Infinite Jest - David Foster Wallace
 * Gravity's Rainbow - Thomas Pynchon
 * The Recognitions - William Gaddis
 * Foucault's Pendulum - Umberto Eco
 * Strange Pilgrims - Gabriel Garcia Marquez
 * Technofeudalism: What Killed Capitalism - Yanis Varoufakis
 * Capital: Volume I - Karl Marx
 * The Selfish Gene - Richard Dawkins
 * The God Delusion - Richard Dawkins
 * The Abolition of Man - C. S. Lewis
 * Dopesick: Dealers, Doctors and the Drug Company that Addicted America - Beth Macy
 * No More Tears: The Dark Secrets of Johnson & Johnson - Gardiner Harris
 * All The Devils Are Here - Bethany McLean, Joe Nocera
 * Right/Wrong: How Technology Transforms Our Ethics - Juan Enriquez
 * The Origin of Consciousness in the Breakdown of the Bicameral Mind - Julian Jaynes
 * The Undiscovered Self - C. G. Jung
 * Knowledge in a Nutshell: Carl Jung - Gary Bobroff
 * The Looming Tower: Al-Qaeda and the Road to 9/11 - Lawrence Wright
 * Paradise Lost & Paradise Regained - John Milton
 * The Lord of the Rings - J. R. R. Tolkien
 * American Psycho - Bret Easton Ellis
 * The Bandini Quartet - John Fante
 * Of Human Bondage - W. Somerset Maugham
 * The Return of the Native - Thomas Hardy
 * The Moon is Down - John Steinbeck
 * A Clockwork Orange - Anthony Burgess
 * Rapture - John Shirley
 * The Racket - Conor Niland
 * The Famine Plot: England's Role in Ireland's Greatest Tragedy - Tim Pat Coogan
 * The Twelve Apostles - Tim Pat Coogan
 * Discourses - Niccolo Machiavelli
 * The 5 Types of Wealth - Sahil Bloom
 * The Art of Laziness - Library Mindset
 * Rapture - John Shirley